{
    "ๅ": "1",
    "1": "ๅ",
    "/": "ฝ",
    "2": "/",
    "_": "3",
    "3": "_",
    "ภ": "4",
    "4": "ภ",
    "ถ": "5",
    "5": "ถ",
    "ุ": "6",
    "6": "ุ",
    "ึ": "7",
    "7": "ึ",
    "ค": "8",
    "8": "ค",
    "ต": "9",
    "9": "ต",
    "จ": "0",
    "0": "จ",
    "ข": "-",
    "-": "ข",
    "ช": "=",
    "=": "ช",
    "ๆ": "q",
    "q": "ๆ",
    "ไ": "w",
    "w": "ไ",
    "ำ": "e",
    "e": "ำ",
    "พ": "r",
    "r": "พ",
    "ะ": "t",
    "t": "ะ",
    "ั": "y",
    "y": "ั",
    "ี": "u",
    "u": "ี",
    "ร": "i",
    "i": "ร",
    "น": "o",
    "o": "น",
    "ย": "p",
    "p": "ย",
    "บ": "[",
    "[": "บ",
    "ล": "]",
    "]": "ล",
    "ฟ": "a",
    "a": "ฟ",
    "ห": "s",
    "s": "ห",
    "ก": "d",
    "d": "ก",
    "ด": "f",
    "f": "ด",
    "เ": "g",
    "g": "เ",
    "้": "h",
    "h": "้",
    "่": "j",
    "j": "่",
    "า": "k",
    "k": "า",
    "ส": "l",
    "l": "ส",
    "ว": ";",
    ";": "ว",
    "ง": "'",
    "'": "ง",
    "ผ": "z",
    "z": "ผ",
    "ป": "x",
    "x": "ป",
    "แ": "c",
    "c": "แ",
    "อ": "v",
    "v": "อ",
    "ิ": "b",
    "b": "ิ",
    "ื": "n",
    "n": "ื",
    "ท": "m",
    "m": "ท",
    "ม": ",",
    ",": "ม",
    "ใ": ".",
    ".": "ใ",
    "ฝ": "/"
}