{
    "+": "๙",
    "!": "+",
    "๑": "@",
    "@": "๑",
    "๒": "#",
    "#": "๒",
    "๓": "$",
    "$": "๓",
    "๔": "%",
    "%": "๔",
    "ู": "^",
    "^": "ู",
    "฿": "&",
    "&": "฿",
    "๕": "*",
    "*": "๕",
    "๖": "(",
    "(": "Z",
    "๗": ")",
    ")": "X",
    "๘": "_",
    "_": "๘",
    "๙": "+",
    "๐": "Q",
    "Q": "๐",
    "\"": ".",
    "W": "\"",
    "ฎ": "E",
    "E": "ฎ",
    "ฑ": "R",
    "R": "ฑ",
    "ธ": "T",
    "T": "ธ",
    "ํ": "Y",
    "Y": "ํ",
    "๊": "U",
    "U": "๊",
    "ณ": "I",
    "I": "ณ",
    "ฯ": "O",
    "O": "ฯ",
    "ญ": "P",
    "P": "ญ",
    "ฐ": "{",
    "{": "ฐ",
    ",": "}",
    "}": ",",
    "ฤ": "A",
    "A": "ฤ",
    "ฆ": "S",
    "S": "ฆ",
    "ฏ": "D",
    "D": "ฏ",
    "โ": "F",
    "F": "โ",
    "ฌ": "G",
    "G": "ฌ",
    "็": "H",
    "H": "็",
    "๋": "J",
    "J": "๋",
    "ษ": "K",
    "K": "ษ",
    "ศ": "L",
    "L": "ศ",
    "ซ": ":",
    ":": "ซ",
    ".": "\"",
    "Z": "(",
    "X": ")",
    "ฉ": "C",
    "C": "ฉ",
    "ฮ": "V",
    "V": "ฮ",
    "ฺ": "B",
    "B": "ฺ",
    "์": "N",
    "N": "์",
    "?": "ฦ",
    "M": "?",
    "ฒ": "<",
    "<": "ฒ",
    "ฬ": ">",
    ">": "ฬ",
    "ฦ": "?"
}